000000000000000000000000000000000000000000000000000000000
000000000000000000000000000000000000000000000000000000000
000000000000000000000000000000000000000000000000000000000
000000000000000000000000000000000000000000000000000000000
000000000000000000000000000000000000000000000000000000000
000000000000000000000000000000000000000000000000000000000
000000000000000000000000000000000000000000000000000000000
000000000000000000000000000000000000000000000000000000000
000000000000000000000000000000000000000000000000000000000
000000000000000000022222000000000000000000000000000000000
000000000000000000001110000000000000000000000000000000000
000000000000000000000000000000000000000000000000000000000
000000000000000000000000000000000000000002222200000000000
000000000000000000000000000000000000000000111000000000000
000000000000000000000000000000000000000000000000000000000
000000000000000040000000000000000000000000000000000000000
000000000000002222200000000000000000000000000000000000000
000000000000000111000000000000000000000000000000000000000
000000000000000000000000000000000000000000000000000000000
000000000000000000000000000000000000000000000000000000000
000000000000000000000000000000000000000000000000000000000
000000000000000000000000000000000400000000000000000000000
000000000004000000000000000000000200000000000000000000000
000000000222220000000000000000000000000000000000000000000
000000000011100000000000000000000000000000000000000000000
000000000000000000000000000000000000000000000000000000000
000000000000000000000000000000000000000000000000000000000
000000000000000000000000000000000000000000000000000000000
000000000000000000000000000000000000000000000000000000000
000000400000000000000000000000000000000000000000000000000
000022222000000000000000000000000000000000000000000000000
000001110000000000000000000000000000000000000000000000000
000000000000000000000000000000000000000000000000000000000
000000000000000000000000000000000000000000000000000000000
000000000000000000000000000000000000000000000000000000000
000000000000000000000000000000000000000000000000000000000
004000000000000000000000000000000000000000000000000000000
222220000022232220000022200000000000000000000000000000000
011100000001111100000001000000000000000000000000000000000
000000000000111000000000000000000000000000000000000000000
000000000000000000000000000020000000000000000000000000000
000000000000000000000000000000000000000000000000000000000
000000000000000000000000000000000000000000000000000000000
000000000000000000000000000000002000000000000000000000000
000000000000000000000000000000000000000000000000000000000
000000000000000000000000000000000000000000000000000000000
000000000000000000000000000000000000222000000000000000000
000000000000000000000000000000000000010000022000000000000
000000000000000000000000000000000000000000000000000000000
000000000000000000000000000000000000000000000000000000000
000000000000000000000000000222000000000000002222000000000
000000000000000000000000000010000000000000000110000000000
000000000000000000000000000000000000000000000000000000000
000000000000000000022222000000000000222220000000000000000
000000000222220000001110000000000000011100000000000000000
000000000011100000000000000000000000000000000000000000000
000000000000000000000000000000000000000000000000000000000
022222000000000000000000000000000000000000000000000000000
001110000000000000000000000000000000000000000000000000000
000000000000000000000000000000000000000000000000000000000
000000022222000020000020000022222000000000000000000000000
000000001110000000000000000001110000000000000222000000000
000000000000000000000000000000000000000000000010000000000
000000000000000000000000000000000000222000000000000000000
000000000000000000000000000000000000010000000000000222220
000000000000000000000000000000000000000000000000000011100
000000000000000000000000000000000000000000000000000000000
000000000000000000000000000000000000000000002222200000000
000000000000000000000000000000000000000000000111000000000
000000000000000000000000000000000000000000000000000000000
000000000000000000000000000002222200000222000000000000000
000000000000000000002222200000111000000010000000000000000
000000000000000000000111000000000000000000000000000000000
000000050600000000000000000000000000000000000000000000000
002222222222222220000000000000000000000000000000000000000
001111111111111110000000000000000000000000000000000000000
001111111111111110000000000000000000000000000000000000000
001111111111111110000000000000000000000000000000000000000
001111111111111110000000000000000000000000000000000000000
001111111111111110000000000000000000000000000000000000000
001111111111111110000000000000000000000000000000000000000
001111111111111110000000000000000000000000000000000000000
001111111111111110000000000000000000000000000000000000000
001111111111111110000000000000000000000000000000000000000
